SO              		./textures/wall2.png 
WE	./textures/wall3.png                             
NO           			./textures/wall1.png
EA 	              ./textures/wall4.png                                  

F 2,20,100           
C 225,30,0 

        1111111111111111111111111
        10000000001100000000000001
        1011000001110000000000001
        1001000000000000000000001
        1111111111111111111111111
111111111011000001110000000000001
100000000011000001110111111011111
11110111111111011100000010001
111101111111110111010100100011
11000000110101011100000010001
10000000000000001100000010001
10000000000000000101010010101
01000001110101011111011110N01
0110111 1110101 101111010001
0111111 1111111 111111111011
0111111 1111111 111111111011
0111111 1111111 111111111011
1111111111111111111111111111