NO           			./textures/wall1.png
SO              		./textures/wall2.png 
WE	      		    ./textures/wall3.png                                        		           
EA  	              ./textures/wall4.png                     
 
F 255	,255, 	      255           
C	225      ,        30,       0 

        1111111111111111111111111
        1000000000110000000000001
        1011000001110000000000001
        1001000000000000000000001
111111111011000001110000000000001
100000000011000001110111101111111
11110111111111011100000010001
111101111111110111010100100011
11000000110101011100000010001
10000000000000001100000010001
10000000000000001101010010001
11000001110101011111011110N0111
11110111 1110101 101111010001
11111111 1111111 111111111111