EA  	              ./textures/wall4.png                     
WE	      		    ./textures/wall3.png                                        		           
SO              		./textures/wall2.png 
NO           			./textures/wall1.png
 
F 128, 128, 128           
C 128, 128, 128

        1111111111111111111111111
        1000000000110000000000001
        1011000001110000000000001
        1001000000000000000000001
111111111011000001110000000000001
10000000001100000111011111D111111
11110111111111011100000010001
111101111111110111010100100011
110000001101010111000000D0001
10000000000000001100000010001
10000000000000001101010010001
11000001110101011111011110N111
11110111 1110101 101111010001
11111111 1111111 111111111111